111111111
10000C001
100010C01
11E0P0001
111111111