11111111111
100000P0001
1CD000C0001
1E000C01111
11111111111
10000000001
1CD000C0001
1E000C01111
11111111111
10000000001
1CD000C0001
1E000C01111
11111111111
10000000001
1CD000C0001
1E000C01111
11111111111