111111111
10000C001
111111001
10EP00001
111111111