11111111
10C00001
1C000001
100P0001
10E0C001
11111111