11111111111111111
1C000000001110001
10000001001E10001
1P00000100C000001
11111111111111111
