111111111
10000C001
111111001
100P00001
111111111