111111111
10000C001
100000C01
100P00E01
111111111