111111111
10000C001
100000C01
111P11E01
111111111